E********
* *      
* *** * *
* * * *  
* * S * *
* * * *  
* * *** *
*        
********E