***************
*S            *
*** ********* *
* * * *        
* *** ***** * *
* * * * * *    
* * *** * * * *
* * * * * * *  
* * * *** *** *
* * * * * *    
* * * ***** * *
* * * *        
***** *** *****
* * E*         
***************