*********
*S      *
***** ***
* *      
*   * * *
* * * *  
* * *** *
*   E*   
*********